அ ஆ இ ஈ உ ஊ எ ஏ ஐ ஒ ஓ ஔ
அ ஆ இ ஈ உ ஊ எ ஏ ஐ ஒ ஓ ஔ
அ ஆ இ ஈ உ ஊ எ ஏ ஐ ஒ ஓ ஔ
அ ஆ இ ஈ உ ஊ எ ஏ ஐ ஒ ஓ ஔ
ஔ ஓ ஒ ஐ ஏ எ ஊ உ இ ஈ ஆ அ
ஔ ஓ ஒ ஐ ஏ எ ஊ உ இ ஈ ஆ அ
ஔ ஓ ஒ ஐ ஏ எ ஊ உ இ ஈ ஆ அ
ஔ ஓ ஒ ஐ ஏ எ ஊ உ இ ஈ ஆ அ
அ இ உ எ ஐ ஒ ஆ ஈ ஊ ஏ ஓ ஔ
அ இ உ எ ஐ ஒ ஆ ஈ ஊ ஏ ஓ ஔ
அ இ உ எ ஐ ஒ ஆ ஈ ஊ ஏ ஓ ஔ
அ இ உ எ ஐ ஒ ஆ ஈ ஊ ஏ ஓ ஔ

